########################
#......................#
#..P...................#
#......................#
#......##########......#
#......#........#......#
#......#..####...#.....#
#......#..#..#...#.....#
#......#..#..#...#.....#
#......#..####...#.....#
#......#........#......#
#......##########......#
#......................#
#......................#
#......................#
#......................#
#......................#
#......................#
#......................#
#......................#
#......................#
#......................#
#......................#
########################